B                          BBB
B                          BBB
B                          BBB
B      KKK  KKKK  KKK      BBB
B                          BBB
B    K                K    BBB
B    KK              KK    BBB
B                          BBB
B        K        K        BBB
B       KK        KK       BBB
B     K              K     BBB
B                          BBB
B   K                  K   BBB
B  KK                  KK  BBB
B                          BBB
B            l             BBB
BBBBBBBBBBBBBBBBBBBBBBBBBBBBBB
BBBBBBBBBBBBBBBBBBBBBBBBBBBBBB
BBBBBBBBBBBBBBBBBBBBBBBBBBBBBB
BBBBBBBBBBBBBBBBBBBBBBBBBBBBBB